add → addition
app → application
auth → authentication
calc → calculate
cfg → configuration
char → character
del → delete
dev → development
dir → directory
elem → element
env → environment
err → error
exec → execute
expr → expression
id → identifier
init  → initialize
len → length
max → maximum
min → minimum
msg → message
num → number
req → request
resp → response
temp → temporary
util → utility
val → value
src → source
fmt → format
idx → index
obj → object
